############
#O..$$$$$$$#
#$O$O$O$O$$#
#$$$ $$$$$$#
#$#O#O#O#O$#
#$$$.O .O.$#
#&......X.O#
#OOOOOOOOOO#
#OOOOOOOOOO#
#          #
############