########################################
#..OOOO.......O........................#
#.............O........................#
#....$........O.................X......#
#.............O........................#
#....X...................$.............#
#........................$.......$$$$$.#
#........................$.......$$$$$.#
#................................$$$$$.#
#..................  O&OO      ..$$$$$.#
#...X..................................#
#......................................#
#......................................#
#......................                #
########################################