#######
#$#$$$#
#$$O$$#
#$$#$$#
#$$O$$#
# &X$.#
#$$$$O#
#######